11111111111111111
10000110000000001
11000000000000011
11000000000000011
10000000000000001
10101010100011111
10000110000000001
11111111111111111
