NO ./texture/north2.XPM

F 98,61,53
WE ./texture/west2.XPM

EA ./texture/east2.XPM
R 600 400

SO ./texture/south2.XPM
S ./texture/barrel.XPM
C 119,136,200

11111111111111111
10101200000000001
10000000010000001
10000000010000001
10000000010000001
10000000010000001
10000000010000001
10020202020001001
10010001110000001
10000000000001001
100000200W0001001
11111111111111111
