NO ./texture/north2.XPM

F 98,61,53
WE ./texture/west2.XPM

EA ./texture/east2.XPM
R 600 400

SO ./texture/south2.XPM
S ./texture/barrel.XPM
C 119,136,200

11111111111111111
10111200000000121
10100000010000101
10100000010011101
10100000010011001
10000000010011001
11111000010000001
10000001020001001
12010001110000001
11110000000001001
100000200W0001001
11111111111111111
