
F 98,61,53
NO ./texture/north2.XPM
WE ./texture/west2.XPM
EA ./texture/east2.XPM
R 640 480

C 119,136,153

SO ./texture/south2.XPM
S ./texture/barrel.XPM

11111111111111111
12000002111200001
10000000000111001
11110000000001001
10S10001110001001
10010001110000001
10010021110000001
10011111120001111
10000001100001001
11110111100001001
10000000000001001
12110201110000021
11111111111111111
