
F 98,61,53
NO ./texture/north2.XPM
WE ./texture/wood.xpm
EA ./texture/purplestone.XPM
R 600 450

C 119,136,153

SO ./texture/south2.XPM
S ./texture/greenlight.XPM

11111111111111111
12000002111200001
10000000002111001
11110000000001001
10S10001110001001
10010001110000001
10010021110000021
10011111120021111
12000001100001201
11110111100001001
10000000000021001
12111021100000021
11111111111111111
