
F 98,61,53
NO ./texture/north2.XPM
WE ./texture/west2.XPM
EA ./texture/east2.XPM
R 640 480

C 119,136,153
SO ./texture/south2.XPM

11111111111111111
10000000111000001
10000000000001001
11100000000000001
10010E00000000001
10010000000000001
10010001110000001
10010001110000001
10000000000001001
11110000000000001
10000000000001001
10010001110000001
11111111111111111
