
F 98,61,53
NO ./texture/north2.XPM
WE ./texture/west2.XPM
EA ./texture/east2.XPM
R 640 480

C 200,136,153

SO ./texture/south2.XPM
S ./texture/barrel.XPM

1 1 1 1 1 1 1 1 1 1 1 1
1 0 0 0 1 0 0 0 0 1 1 1
1 0 0 0 2 0 0 0 0 0 2 1
1 0 1 2 1 0 0 0 0 1 1 1
1 0 1 0 0 0 0 0 0 0 0 1
1 0 1 0 0 0 0 0 0 0 0 1
1 0 1 0 0 0 0 0 0 0 0 1
1 0 2 0 0 0 0 0 1 1 1 1
1 0 0 0 0 2 0 0 0 0 0 1
1 0 0 0 0 0 0 0 0 0 0 1
1 0 N 0 0 0 0 0 0 0 0 1
1 1 1 1 1 1 1 1 1 1 1 1
