11111111111111111
10000000111000001
10000000000001001
10000000000000001
10010001110000001
10000000000001001
10010001110000001
10010001110000001
10000000000001001
11110000000000001
10000000000001001
10010001110000001
11111111111111111
